EA ./textures/Brick_Grey.xpm
NO ./textures/Brick_Grey.xpm
SO ./textures/Brick_Grey.xpm
WE ./textures/Brick_Grey.xpm
DO ./textures/wood.xpm

V

C 100,100,100
F 100,100,100

 1111111                    1111111
100000001                  100000001
100000001111111111111111111100000001
100110001000000000000000000100011001
10011000D000000000000000000100011001
100000001000000000000000000100000001
100000001000000000000000000100000001
111111D11000000000000000000100000001
 1100000000000000000000000011111111
  10000000000000000000000000000001
  111100000111111D1111110000011111
  10010000010000000000010000010001
  100D0000010000000000010000010001
  100100000100000000000100000D0001
  10010000010000000000010000010001
  100100000D00000000000D0000010001
  10010000010000000000010000010001
  10010000010000000000010000010001
  100D0000010000000000010000010001
  100100000100000000000100000D0001
  111100000111111D1111110000011111
  10000000000000000000000000000001
 1111111000000000000000000011111111
100000010000000000000000000100000001
100000010000000000000000000100000001
1000000D0000000000000000000D00000001
111D11110000000000000000000100000001
10000000000000000N000000000100000001
1D1D1D1D1111111111111111111000000001
101010101                 1000000001
 1111111                   11111111