EA ./textures/leaves.xpm
NO ./textures/Brick_Grey.xpm
SO ./textures/Brick_Grey.xpm
WE ./textures/Concrete_Lines_Grey.xpm

V

F 100,100,100
C 128,255,190

11111111111111111111111111111111111111111111111111
111000100000000010010110000E0000010011010000000001
10010000000000000010000010000000110000001100000001
10000000001000000000000000000100000000100000000001
10000000000000000000000000000000000000000000000001
10000000000000000000011000000100000000010001010001
10000000001000001000000000000001000000010001010001
10000000000000000000000000000000000000000000000001
10000000011010000110000000000000000000000000000001
10000000001000000000000000000000100000000000100001
11000000110100000000001000100000000000000000100001
10000000000000010000000000000100000000000000010001
10000011000000000000000000000000001011000010000001
10000000101000000000000110000000000000100000011001
11000000000000100110000000001000000010000000000001
10000000000000010010000000000001010000001100100001
10000000010000000000000000000100000000000000000001
10010000001000000010000000000000000000001000000001
10000001100100000101000001000001000001000000010011
10000001000000000000000100000100000000000000000001
10000100010000000000010000000000001000000000000101
10001000001000000000000000000000000000000000000001
10010000000000010000000000001000000000000100000001
10000000100000000000000000000000000000000000000001
10010000000000000000010000000000000000000000000001
10010000000100000010000000110000000000000000000111
11000000000000000000000000000000000000100000000001
10000000000000000011010000101000000000000000000001
10001001010000000010000000000000001000001000000001
10000000000000001000000000000010000000000000010001
10000001000000000000000000000000001100100000000001
10100100000000000000000000100000000000010000000001
10000110001000101000100000000000000000000100000001
10000000000010000001000000000000010000000000010001
10010000100000000000000000000000000101000000000001
10100000000000001000100000000000000000000000010001
10000000000010000000000000000000000000000000001001
10000000000000000000000000000100000000000000001001
10000000000100000000001000000000000100000001000001
10000000000010010010000000000000000000000000100011
11000101000000001001000000000000001000000000000001
10000110000000000000110000000010001100000000000101
10000100001100010010000000000100010010000000000001
10000011000000000000000000100000000000000010100001
10001000000000001100000000001000010000000010000001
10100000000000010000100000000110010000000000000011
11000001000000000000010001000000000100001000010001
11000000000101000000000000000010000100000000000011
10000010000100000000001000000100000000000100000001
10001000000100000000000000000001010000000000000001
11111111111111111111111111111111111111111111111111