EA ./textures/leaves.xpm
NO ./textures/Brick_Grey.xpm
SO ./textures/Brick_Grey.xpm
WE ./textures/Concrete_Lines_Grey.xpm



F 100,100,100
C 128,255,190

11111111
100000001
1E0000011
100000001
111111111