EA ./textures/Concrete_Lines_Grey.xpm
NO ./textures/Brick_Grey.xpm
SO ./textures/Brick_Grey.xpm
WE ./textures/Concrete_Lines_Grey.xpm
DO ./textures/metal_door.xpm

V

F 100,100,100
C 128,255,190

1111111111111111111111111111111
1101011011111010111010000100101
1101010010000010100011001101101
1101111110111110001110010101011
1101000011000000101000111011010
1101011101111111101111101101011
1010111011000000010101101010101
1010001011011111010100101010101
1111111000100001111110101010101
1100010111111110000010101010101
111111010E010011111110111010101
1100100111001101000000000110101
0111101001111011011111010000101
1100111101001010101000111111101
0101000001010110101010100000101
1101011111010100111111011110101
0101010101110111100010010010101
1101010101001000101011111101111
1001110101111011010100000101001
1110000110001011010101101001011
1010110000111011001011101111010
0010101111000001101101001001011
0110111010111101001101011111101
0011000010101001110011000001010
1010111110010110001100011111011
1101101010110101110101101010101
1001101011111101010101001010100
1110011100010011110101111100101
1011110111011110010101000101011
1000010101000001010101011101010
1111111111111111111111101101110
