1111111111111
10000000000C1
1001111111001
1P0111E001001
1000000000001
1111111111111