111111111111111
1000C1C001110C1
100001000000001
1P1000110100101
111000000010101
1C0010011C001E1
111111111111111