111111111111111111111111111111111111111111111111111
10000000000000000000000000000000000000000000000E001
1P0000000000000000000000000000000000000000000000001
100000000000000000000000000000000000000000000000C01
111111111111111111111111111111111111111111111111111