111111111111111
1P00000100000E1
100000010000001
10000C010000001
100000010000001
1C0000010000C01
111111111111111