111111111111111111111111111111111111111111111111
10001C001100100101000000010100000000100001010001
100101000010000100010010001001001010001001000101
10001001001001C01010101000001010100C0001C0010101
101001010010100001000010000010000000100000010001
1P0010000010001000001000100100000100010001000011
1C0001010010101000010000100001000010C001000001E1
100100000001000000010000000010000000010000100101
111100000010000000100C00010000001000000100000001
100001000100111100100000100010011001110110000101
110101101010101010010101010101010101101010101011
1000000000C0010000101010101000C00000010000000101
111111111111111111111111111111111111111111111111