11111111111
10000000001
1P000000001
1000C000111
100000001E1
11111111111